89 89 11 20 20 20 20 20 20 20 13 89 11 20 20 20 20 20 20 20 20 20 20 20 20 13 22 78 52 52 52 0 0 0 0 0 0 0 0 0 0 0 0 0 0 0 0 0 0 0 0 0 0 0 0 0 0 0 0 0 0 0 0 0 0 0 0 0 0 0 0 0 0 0 0 0 0 0 0 0 0 0 0 0 0 0 0 0 0 0 0 0 0 0 0 0 0 0 0 0 
11 20 21 40 51 51 51 53 53 53 19 20 21 52 52 40 53 53 51 51 0 52 52 51 40 19 20 21 52 0 52 0 0 0 0 0 0 0 0 0 0 0 0 0 0 0 0 0 0 0 0 0 0 0 0 0 0 0 0 0 0 0 0 0 0 0 0 0 0 0 0 0 0 0 0 0 0 0 0 0 0 0 0 0 0 0 0 0 0 0 0 0 0 0 0 0 0 0 0 0 
10 40 40 53 53 53 40 40 51 53 53 53 52 52 52 53 53 51 0 23 34 34 34 45 52 51 51 51 52 52 51 0 0 41 41 41 41 41 41 41 41 41 41 41 41 41 41 41 41 41 41 41 41 41 0 0 0 0 0 0 0 0 0 0 0 0 0 0 0 0 0 0 0 0 0 0 0 0 0 0 0 0 0 0 0 0 0 0 0 0 0 0 0 0 0 0 0 0 0 0 
10 40 53 53 51 0 52 51 40 40 52 53 53 53 53 53 51 51 0 5 38 38 38 7 0 52 51 51 51 52 51 41 41 41 0 0 0 41 41 41 41 41 41 0 42 42 42 42 42 51 51 51 51 41 41 41 0 0 0 0 0 0 0 0 0 0 0 0 0 0 0 0 0 0 0 0 0 0 0 0 0 0 0 0 0 0 0 0 0 0 0 0 0 0 0 0 0 0 0 0 
10 40 53 52 52 52 52 51 51 40 40 51 51 51 52 40 40 51 0 5 38 36 38 7 0 51 51 51 53 52 52 51 51 51 51 51 41 41 42 42 0 0 41 42 51 51 51 51 51 51 42 42 41 41 0 41 41 0 0 0 0 0 0 0 0 0 0 0 0 0 0 0 0 0 0 0 0 0 0 0 0 0 0 0 0 0 0 0 0 0 0 0 0 0 0 0 0 0 0 0 
10 40 51 52 52 52 52 52 51 52 40 0 52 51 51 52 40 40 0 16 4 38 3 18 0 51 51 51 53 40 52 51 51 0 0 41 51 51 51 51 51 51 51 51 51 0 41 41 41 41 41 42 42 41 0 0 41 41 0 0 0 0 0 0 0 0 0 0 0 0 0 0 0 0 0 0 0 0 0 0 0 0 0 0 0 0 0 0 0 0 0 0 0 0 0 0 0 0 0 0 
10 40 52 52 52 0 52 52 51 52 52 51 51 52 51 51 52 40 40 0 5 6 14 45 42 51 52 51 51 41 52 41 51 41 42 42 42 41 41 0 0 41 42 42 42 42 42 41 41 41 41 0 41 42 42 41 0 41 0 0 0 0 0 0 0 0 0 0 0 0 0 0 0 0 0 0 0 0 0 0 0 0 0 0 0 0 0 0 0 0 0 0 0 0 0 0 0 0 0 0 
10 40 52 52 0 0 0 52 51 51 52 51 40 0 51 51 51 51 40 40 16 4 6 14 45 41 51 0 51 53 41 41 51 41 43 43 41 41 41 41 41 41 0 0 0 43 51 42 42 41 41 0 0 41 42 41 41 41 0 0 0 0 0 0 0 0 0 0 0 0 0 0 0 0 0 0 0 0 0 0 0 0 0 0 0 0 0 0 0 0 0 0 0 0 0 0 0 0 0 0 
10 51 52 52 0 0 0 0 52 51 52 0 40 52 51 52 51 51 52 40 52 0 4 6 14 45 51 51 51 53 41 41 51 41 41 41 43 41 41 41 41 41 41 41 51 51 51 0 42 42 42 41 41 0 43 42 41 41 41 0 0 0 0 0 0 0 0 0 0 0 0 0 0 0 0 0 0 0 0 0 0 0 0 0 0 0 0 0 0 0 0 0 0 0 0 0 0 0 0 0 
10 53 51 16 4 6 3 18 52 51 52 52 40 40 51 52 51 51 51 52 40 52 5 6 6 7 41 51 51 51 41 41 51 42 43 43 41 41 41 41 41 53 0 51 51 41 41 41 41 51 42 42 41 41 41 42 51 0 41 0 0 0 0 0 0 0 0 0 0 0 0 0 0 0 0 0 0 0 0 0 0 0 0 0 0 0 0 0 0 0 0 0 0 0 0 0 0 0 0 0 
10 53 51 0 5 6 7 0 52 51 51 52 52 40 51 51 51 0 51 51 40 52 16 4 6 14 45 41 52 51 51 41 51 42 42 42 42 42 42 41 41 41 43 51 0 0 41 41 41 43 0 42 42 41 0 41 51 51 41 0 0 0 0 0 0 0 0 0 0 0 0 0 0 0 0 0 0 0 0 0 0 0 0 0 0 0 0 0 0 0 0 0 0 0 0 0 0 0 0 0 
10 53 51 0 5 6 14 45 52 0 51 52 52 40 40 40 52 52 52 40 40 52 52 5 6 6 14 45 52 52 51 0 51 41 0 41 53 41 42 42 0 41 51 51 51 51 51 0 41 51 41 0 42 42 42 41 42 51 41 0 0 0 0 0 0 5 6 6 6 6 7 43 0 0 0 89 0 0 0 0 0 0 0 0 0 0 0 0 0 0 0 0 0 0 0 0 0 0 0 0 
10 40 51 52 5 6 6 7 52 0 52 51 52 52 52 40 40 40 40 51 52 52 52 16 4 6 6 7 41 52 52 53 51 42 41 41 41 53 53 42 42 41 51 0 0 42 51 51 51 51 41 41 41 0 42 41 42 51 41 0 0 0 0 0 43 16 4 6 6 3 18 43 0 0 42 89 0 0 42 0 42 42 0 0 0 0 0 0 0 0 0 0 0 0 0 0 0 0 0 0 
10 40 51 52 16 4 6 7 52 52 52 51 51 51 51 51 51 51 51 52 52 52 52 0 5 6 6 14 45 52 52 0 51 42 42 41 41 41 41 0 42 51 51 41 41 42 0 41 41 41 41 41 0 42 42 41 41 51 41 0 0 0 0 0 0 43 5 6 6 7 43 43 42 42 42 89 0 42 42 0 0 42 0 0 0 0 0 0 0 0 0 0 0 0 0 0 0 0 0 0 
10 40 40 52 0 5 6 7 0 52 52 52 52 52 52 52 52 52 52 52 52 52 0 23 15 6 6 6 14 45 42 41 41 51 51 42 42 42 41 51 51 51 0 41 0 42 42 43 41 41 41 42 42 42 41 41 41 0 41 0 0 0 0 0 43 23 15 6 6 7 43 42 42 42 42 89 0 42 42 0 0 42 0 0 0 0 0 0 0 0 0 0 0 0 0 0 0 0 0 0 
22 78 40 51 52 5 6 14 34 34 34 34 34 34 34 34 34 34 34 34 34 34 34 15 6 6 6 6 6 14 45 42 41 0 51 51 51 51 51 51 42 41 41 41 51 51 42 41 41 42 42 42 0 0 41 41 0 41 41 0 0 0 0 43 0 5 6 6 6 7 43 42 42 42 42 89 0 42 42 42 0 42 0 0 0 0 0 0 0 0 0 0 0 0 0 0 0 0 0 0 
89 10 40 40 0 5 6 6 6 6 6 6 6 6 6 6 6 6 6 6 6 6 6 6 6 6 6 6 6 6 14 34 45 41 41 41 41 0 42 42 41 41 41 0 41 51 0 41 41 41 0 43 41 41 41 41 41 41 0 41 51 43 43 23 34 15 6 6 3 18 43 42 42 42 89 89 42 42 0 42 0 42 0 0 0 0 0 0 0 0 0 0 0 0 0 0 0 0 0 0 
89 10 43 43 0 16 17 17 17 17 17 17 17 17 17 17 17 17 17 17 4 6 6 6 6 6 6 6 6 6 6 6 14 34 45 42 41 41 41 41 41 53 0 41 41 0 41 41 41 41 41 41 41 0 0 41 0 0 42 0 23 34 34 15 6 6 6 6 7 43 43 42 42 42 89 42 42 51 51 43 51 51 0 0 41 41 41 0 0 0 0 0 0 0 0 0 0 0 0 0 
11 21 0 43 43 43 43 43 43 43 43 52 52 52 52 52 52 0 43 43 16 17 17 17 4 6 6 6 6 6 6 6 6 6 14 34 34 45 42 41 41 41 41 41 41 41 41 41 41 41 51 23 34 34 34 34 34 34 34 34 15 6 6 6 6 6 6 3 18 43 0 42 42 42 89 0 42 51 42 51 51 51 0 0 0 41 51 0 0 0 0 0 0 0 0 0 0 0 0 0 
10 42 42 52 52 42 42 42 42 42 42 53 53 53 52 52 52 52 43 0 0 52 52 0 16 4 6 6 6 6 6 6 6 6 6 6 6 14 34 34 34 34 34 45 42 51 23 34 34 34 34 15 6 6 6 6 6 6 6 6 6 6 6 6 6 3 17 18 42 43 43 43 43 89 89 43 42 0 51 51 51 0 41 0 0 0 51 0 51 51 0 0 0 0 0 0 0 0 0 0 
10 52 42 42 42 42 43 53 53 42 42 52 52 53 53 53 53 53 53 52 52 52 52 0 23 15 6 6 3 17 17 17 4 6 6 6 6 6 6 6 6 6 6 14 34 34 15 6 6 6 6 6 6 6 6 6 6 6 6 6 6 3 17 17 17 18 41 43 41 41 0 0 43 89 43 43 52 52 52 42 0 41 53 42 42 42 41 0 0 0 0 0 0 0 0 0 0 0 0 0 
10 52 52 43 42 43 43 53 52 42 42 52 42 42 52 52 53 53 52 0 0 0 23 34 15 6 6 6 7 0 0 51 0 17 17 17 4 6 6 6 6 6 6 6 6 6 6 6 6 6 6 6 6 3 17 17 17 17 17 17 17 18 42 42 43 43 41 41 0 41 51 0 89 89 0 0 42 0 42 42 0 42 0 41 0 0 41 43 0 51 0 0 0 0 0 0 0 0 0 0 
10 52 52 43 42 42 42 42 42 42 42 42 42 42 42 42 42 0 0 23 34 34 15 6 6 6 6 6 7 42 42 41 52 0 51 0 0 17 17 17 17 17 4 6 6 6 6 3 17 17 17 17 17 18 42 42 42 42 42 42 42 51 43 43 43 42 42 52 52 51 53 53 89 89 52 52 42 42 42 42 0 0 51 41 41 41 41 43 0 51 0 0 0 0 0 0 0 0 0 0 
10 52 52 42 42 42 42 42 53 53 52 42 42 42 0 0 23 34 34 15 6 6 6 6 6 6 6 3 18 42 42 41 53 41 41 41 41 41 41 0 51 0 16 17 17 17 17 18 0 51 0 0 0 0 0 43 43 51 53 53 53 51 52 0 42 42 0 52 51 41 53 43 89 89 42 42 0 42 42 52 52 0 0 51 0 41 0 42 52 51 0 0 0 0 0 0 0 0 0 0 
10 52 42 42 52 42 42 0 52 53 42 52 42 0 23 34 15 6 6 6 6 6 6 6 6 3 17 18 52 52 42 52 51 0 41 41 41 41 51 41 52 52 0 0 0 0 41 41 41 41 41 41 52 52 52 51 51 51 51 42 0 52 52 0 42 42 0 52 0 0 43 89 89 89 42 0 42 53 51 0 42 51 51 0 0 52 52 42 52 51 0 0 0 0 0 0 0 0 0 0 
10 42 42 43 52 42 42 52 53 53 42 52 0 23 15 6 6 6 6 6 6 6 6 3 17 18 0 51 52 52 52 52 51 43 43 43 43 43 43 43 43 43 53 43 43 43 43 43 43 51 52 52 51 51 51 51 42 53 51 51 51 52 42 42 42 42 0 52 41 0 51 89 89 41 41 53 51 41 52 52 52 42 0 52 0 0 42 0 51 0 0 0 0 0 0 0 0 0 0 0 
10 42 51 51 43 43 43 43 53 53 52 52 23 15 6 6 6 6 6 6 3 17 17 18 42 51 51 51 52 42 43 52 52 52 0 0 51 51 52 52 52 52 53 53 41 41 41 41 51 51 51 51 51 43 43 43 53 53 42 41 51 51 42 0 0 42 42 52 51 43 51 89 89 52 41 51 51 52 41 52 41 42 42 52 52 0 0 0 51 0 0 0 0 0 0 0 0 0 0 0 
10 0 51 43 0 43 43 43 43 53 52 0 5 6 6 6 3 17 17 17 18 42 41 42 51 51 51 42 52 52 43 43 53 52 52 52 52 52 52 51 51 51 51 51 51 51 51 51 51 52 51 51 41 41 52 53 53 43 43 43 52 51 0 51 51 42 52 53 41 0 51 89 89 53 0 43 51 41 0 53 41 52 52 52 52 52 0 52 0 42 0 0 0 0 0 0 0 0 0 0 
10 51 51 43 43 43 0 0 42 42 52 0 5 6 6 6 7 0 43 43 43 43 52 52 52 52 52 52 52 52 52 43 53 52 52 52 51 51 52 52 41 51 51 51 51 53 53 51 52 52 42 51 0 41 52 53 51 41 41 52 51 51 43 52 52 52 52 41 41 42 51 89 89 0 41 51 0 52 0 0 52 52 42 0 51 52 52 43 0 0 0 0 0 0 0 0 0 0 0 0 
10 51 51 51 51 0 0 0 0 53 53 0 5 6 6 6 7 41 41 41 43 43 52 42 42 52 52 52 52 51 52 52 53 52 52 51 51 52 52 43 43 43 43 43 43 43 53 53 53 53 0 43 43 43 53 0 43 43 43 43 51 51 0 52 0 51 0 41 0 0 89 89 42 42 42 51 0 52 42 52 52 42 42 0 51 51 52 43 0 0 0 0 0 0 0 0 0 0 0 0 
10 0 0 0 51 0 0 0 0 0 0 0 5 6 6 6 7 0 43 43 43 42 52 43 43 51 0 0 52 52 52 52 52 51 52 0 51 52 51 52 51 41 41 41 51 41 51 51 51 51 51 51 51 51 51 51 51 51 51 51 51 41 0 52 52 52 51 0 42 42 89 89 52 41 42 43 0 51 51 52 52 52 0 0 41 43 43 43 0 0 0 0 0 0 0 0 0 0 0 0 
22 67 67 67 67 67 78 51 56 78 0 0 16 17 17 17 18 41 43 0 51 42 51 52 52 51 42 42 42 0 52 51 52 53 52 52 52 0 52 52 52 51 51 51 51 51 53 51 0 41 41 41 51 0 51 52 52 52 51 51 0 41 0 0 42 42 51 52 41 41 89 89 0 0 51 51 51 51 51 51 52 52 52 53 52 52 0 42 0 42 0 0 0 0 0 0 0 0 0 0 
89 89 89 89 89 89 22 67 24 22 78 56 67 67 67 78 0 41 43 43 42 42 51 43 52 52 52 52 52 52 52 51 52 52 41 51 51 52 52 43 52 53 43 53 53 53 43 43 0 43 43 41 51 51 51 52 52 0 51 51 0 41 41 42 42 41 41 43 0 41 89 89 41 0 0 43 0 0 51 51 51 51 43 42 42 52 0 0 42 42 52 0 0 0 0 0 0 0 0 0 
89 11 20 20 20 20 20 20 20 13 22 24 89 89 89 22 78 0 41 43 42 42 42 42 42 42 42 42 42 52 52 51 51 52 0 43 43 43 52 0 0 53 53 53 51 51 51 0 0 0 43 43 43 43 43 43 43 43 41 51 41 41 41 42 0 0 0 41 51 51 89 89 0 41 41 41 41 41 41 0 43 0 0 0 0 42 0 42 42 0 0 0 0 0 0 0 0 0 0 0 
11 21 0 0 0 41 40 0 0 19 20 20 20 20 13 89 10 0 41 43 0 51 43 51 51 43 43 41 42 51 51 51 42 52 51 51 0 51 52 52 0 0 0 0 0 0 0 0 0 0 0 0 0 0 0 0 0 0 0 0 0 0 0 0 0 0 0 0 0 0 89 89 0 0 0 0 0 0 0 0 0 0 0 0 0 0 0 0 0 0 0 0 0 0 0 0 0 0 0 0 
21 0 0 0 0 0 0 0 0 0 0 0 0 0 19 13 22 78 0 41 41 51 42 42 42 42 42 42 42 51 51 42 52 52 0 51 41 51 0 52 52 0 0 0 0 0 0 0 0 0 0 0 0 0 0 0 0 0 0 0 0 0 0 0 0 0 0 0 0 0 89 89 0 0 0 0 0 0 0 0 0 0 0 0 0 0 0 0 0 0 0 0 0 0 0 0 0 0 0 0 
0 0 52 52 51 51 52 52 52 52 52 0 0 0 0 8 89 10 0 41 43 41 41 42 42 41 41 52 52 52 51 51 42 42 52 52 51 52 52 0 0 0 0 0 0 0 0 0 0 0 0 0 0 0 0 0 0 0 0 0 0 0 0 0 0 0 0 0 0 0 89 89 0 0 0 0 0 0 0 0 0 0 0 0 0 0 0 0 0 0 0 0 0 0 0 0 0 0 0 0 
52 52 52 52 51 51 52 52 0 52 52 52 0 0 0 19 13 10 0 52 41 41 41 41 41 42 42 41 41 41 51 51 51 52 52 52 52 52 0 0 0 0 0 0 0 0 0 0 0 0 0 0 0 0 0 0 0 0 0 0 0 0 0 0 0 0 0 0 0 0 89 89 0 0 0 0 0 0 0 0 0 0 0 0 0 0 0 0 0 0 0 0 0 0 0 0 0 0 0 0 
0 0 52 53 53 53 51 52 0 52 52 52 52 0 0 0 8 10 0 0 52 41 41 0 41 42 42 42 52 41 41 41 51 51 41 41 51 51 0 0 0 0 0 0 0 0 0 0 0 0 0 0 0 0 0 0 0 0 0 0 0 0 0 0 0 0 0 0 0 0 89 89 0 0 0 0 0 0 0 0 0 0 0 0 0 0 0 0 0 0 0 0 0 0 0 0 0 0 0 0 
53 53 53 53 52 53 53 53 52 52 52 52 52 52 0 0 8 10 0 0 52 41 42 41 52 42 41 41 42 42 52 41 42 51 51 51 51 51 51 0 0 0 0 0 0 0 0 0 0 0 0 0 0 0 0 0 0 0 0 0 0 0 0 0 0 0 0 0 0 0 89 89 0 0 0 0 0 0 0 0 0 0 0 0 0 0 0 0 0 0 0 0 0 0 0 0 0 0 0 0 
0 52 51 51 52 52 0 53 53 52 52 0 52 53 0 0 8 22 78 0 0 52 42 41 41 51 51 51 51 51 42 41 52 42 41 51 41 51 51 0 0 0 0 0 0 0 0 0 0 0 0 0 0 0 0 0 0 0 0 0 0 0 0 0 0 0 0 0 0 0 89 89 0 0 0 0 0 0 0 0 0 0 0 0 0 0 0 0 0 0 0 0 0 0 0 0 0 0 0 0 
51 51 0 52 52 52 52 52 53 53 52 52 52 53 53 0 19 89 22 78 0 52 42 41 51 51 52 41 41 51 51 51 41 42 51 51 52 51 51 0 0 0 0 0 0 0 0 0 0 0 0 0 0 0 0 0 0 0 0 0 0 0 0 0 0 0 0 0 0 0 89 89 0 0 0 0 0 0 0 0 0 0 0 0 0 0 0 0 0 0 0 0 0 0 0 0 0 0 0 0 
51 52 0 52 52 52 52 52 52 53 53 53 52 52 53 52 0 19 13 10 0 0 42 51 51 41 42 52 52 52 0 42 51 51 51 42 52 51 51 0 0 0 0 0 0 0 0 0 0 0 0 0 0 0 0 0 0 0 0 0 0 0 0 0 0 0 0 0 0 0 89 89 0 0 0 0 0 0 0 0 0 0 0 0 0 0 0 0 0 0 0 0 0 0 0 0 0 0 0 0 
0 52 51 51 51 51 51 41 52 51 51 53 53 52 53 52 0 0 8 22 78 0 0 42 42 42 42 42 52 52 52 42 0 41 41 42 51 51 0 0 0 0 0 0 0 0 0 0 0 0 0 0 0 0 0 0 0 0 0 0 0 0 0 0 0 0 0 0 0 0 89 89 0 0 0 0 0 0 0 0 0 0 0 0 0 0 0 0 0 0 0 0 0 0 0 0 0 0 0 0 
51 51 51 52 51 42 51 51 51 53 51 51 53 52 53 52 52 0 19 13 22 78 0 0 52 42 42 42 42 42 42 42 52 41 41 42 51 51 0 0 0 0 0 0 0 0 0 0 0 0 0 0 0 0 0 0 0 0 0 0 0 0 0 0 0 0 0 0 0 0 89 89 0 0 0 0 0 0 0 0 0 0 0 0 0 0 0 0 0 0 0 0 0 0 0 0 0 0 0 0 
51 51 51 52 42 42 0 42 51 51 51 52 53 41 53 52 52 51 0 19 89 22 78 0 0 52 41 42 42 42 52 52 52 42 42 42 51 51 0 0 0 0 0 0 0 0 0 0 0 0 0 0 0 0 0 0 0 0 0 0 0 0 0 0 0 0 0 0 0 0 0 89 89 0 0 0 0 0 0 0 0 0 0 0 0 0 0 0 0 0 0 0 0 0 0 0 0 0 0 0 
51 51 51 51 42 41 51 52 41 42 51 51 51 41 41 52 52 0 42 0 19 13 22 78 0 51 51 52 41 42 42 42 42 42 42 42 51 41 0 0 0 0 0 0 0 0 0 0 0 0 0 0 0 0 0 0 0 0 0 0 0 0 0 0 0 0 0 0 0 0 0 89 89 0 0 0 0 0 0 0 0 0 0 0 0 0 0 0 0 0 0 0 0 0 0 0 0 0 0 0 
0 51 52 51 53 41 53 53 41 41 41 51 51 41 41 0 52 53 0 51 0 19 13 22 78 0 51 51 52 52 52 41 41 41 42 42 42 41 41 0 0 0 0 0 0 0 0 0 0 0 0 0 0 0 0 0 0 0 0 0 0 0 0 0 0 0 0 0 0 0 0 0 89 89 0 0 0 0 0 0 0 0 0 0 0 0 0 0 0 0 0 0 0 0 0 0 0 0 0 0 
0 41 42 51 51 41 53 41 41 53 53 41 51 51 41 41 0 53 53 0 42 0 19 13 22 67 78 0 0 52 52 52 52 51 42 42 51 42 0 0 0 0 0 0 0 0 0 0 0 0 0 0 0 0 0 0 0 0 0 0 0 0 0 0 0 0 0 0 0 0 0 0 89 89 89 0 0 0 0 0 0 0 0 0 0 0 0 0 0 0 0 0 0 0 0 0 0 0 0 0 
41 41 42 41 51 41 53 42 53 53 53 53 41 51 51 42 42 42 42 53 0 51 0 19 20 13 22 78 0 0 0 52 52 52 52 42 51 42 0 0 0 0 0 0 0 0 0 0 0 0 0 0 0 0 0 0 0 0 0 0 0 0 0 0 0 0 0 0 0 0 0 0 89 89 89 89 0 0 0 0 0 0 0 0 0 0 0 0 0 0 0 0 0 0 0 0 0 0 0 0 
41 53 53 41 51 53 41 42 53 53 42 42 42 42 51 51 42 0 42 53 53 0 42 0 0 19 89 22 67 78 0 51 51 52 52 42 42 42 42 0 0 0 0 0 0 0 0 0 0 0 0 0 0 0 0 0 0 0 0 0 0 0 0 0 0 0 0 0 0 0 0 0 0 89 89 89 0 0 0 0 0 0 0 0 0 0 0 0 0 0 0 0 0 0 0 0 0 0 0 0 
41 53 53 42 42 51 42 42 42 42 42 53 53 42 42 51 51 42 42 42 42 42 53 51 0 0 19 20 13 22 67 78 51 51 52 42 42 51 42 0 0 0 0 0 0 0 0 0 0 0 0 0 0 0 0 0 0 0 0 0 0 0 0 0 0 0 0 0 0 0 0 0 0 0 89 89 0 0 0 0 0 0 0 0 0 0 0 0 0 0 0 0 0 0 0 0 0 0 0 0 
41 53 42 42 0 51 53 42 41 41 53 0 42 42 41 53 51 51 42 53 53 41 42 42 53 42 0 0 19 20 13 10 0 51 52 42 52 51 42 0 0 0 0 0 0 0 0 0 0 0 0 0 0 0 0 0 0 0 0 0 0 0 0 0 0 0 0 0 0 0 0 0 0 0 89 89 0 0 0 0 0 0 0 0 0 0 0 0 0 0 0 0 0 0 0 0 0 0 0 0 
41 53 42 41 0 51 42 42 41 41 41 53 42 0 41 41 41 51 51 53 42 42 41 42 42 42 53 42 51 0 8 89 78 0 52 42 52 51 42 0 0 0 0 0 0 0 0 0 0 0 0 0 0 0 0 0 0 0 0 0 0 0 0 0 0 0 0 0 0 0 0 0 0 0 89 89 0 0 0 0 0 0 0 0 0 0 0 0 0 0 0 0 0 0 0 0 0 0 0 0 
41 41 42 41 53 51 51 42 42 42 42 42 42 51 0 41 41 42 51 0 42 53 41 53 42 42 53 53 53 51 8 89 22 78 52 42 52 52 42 0 0 0 0 0 0 0 0 0 0 0 0 0 0 0 0 0 0 0 0 0 0 0 0 0 0 0 0 0 0 0 0 0 0 0 89 89 0 0 0 0 0 0 0 0 0 0 0 0 0 0 0 0 0 0 0 0 0 0 0 0 
53 41 42 41 42 42 51 53 53 53 42 51 51 41 51 51 42 42 42 51 42 53 41 0 42 53 42 53 51 51 8 89 89 22 78 42 52 52 42 0 0 0 0 0 0 0 0 0 0 0 0 0 0 0 0 0 0 0 0 0 0 0 0 0 0 0 0 0 0 0 0 0 0 0 89 89 0 0 0 0 0 0 0 0 0 0 0 0 0 0 0 0 0 0 0 0 0 0 0 0 
0 41 41 42 42 41 51 51 53 51 51 51 53 53 53 51 51 53 53 42 41 41 42 42 42 42 51 0 51 51 8 89 89 1 22 67 67 78 42 0 0 0 0 0 0 0 0 0 0 0 0 0 0 0 0 0 0 0 0 0 0 0 0 0 0 0 0 0 0 0 0 0 0 0 89 89 0 0 0 0 0 0 0 0 0 0 0 0 0 0 0 0 0 0 0 0 0 0 0 0 
53 41 0 42 42 42 42 51 51 51 53 41 53 53 53 53 42 41 42 42 42 42 42 53 42 51 51 42 42 52 8 89 11 20 20 13 89 22 78 0 0 0 0 0 0 0 0 0 0 0 0 0 0 0 0 0 0 0 0 0 0 0 0 0 0 0 0 0 0 0 0 0 0 89 89 0 0 0 0 0 0 0 0 0 0 0 0 0 0 0 0 0 0 0 0 0 0 0 0 0 
0 0 0 0 41 42 42 41 41 0 0 0 41 41 41 41 42 42 42 42 42 0 0 53 42 53 53 42 42 56 24 89 10 42 42 19 13 89 22 67 78 0 0 0 0 0 0 0 0 0 0 0 0 0 0 0 0 0 0 0 0 0 0 0 0 0 0 0 0 0 0 89 89 89 89 0 0 0 0 0 0 0 0 0 0 0 0 0 0 0 0 0 0 0 0 0 0 0 0 0 
0 0 0 0 0 41 41 42 42 42 0 0 0 53 0 0 42 42 42 0 0 0 0 0 42 52 52 52 56 24 89 89 21 42 42 51 19 20 13 89 22 67 67 78 0 0 0 0 0 0 0 0 0 0 0 0 0 0 0 0 0 0 0 0 0 0 0 0 0 0 89 89 89 89 0 0 0 0 0 0 0 0 0 0 0 0 0 0 0 0 0 0 0 0 0 0 0 0 0 0 
0 0 0 0 0 0 0 0 0 0 42 42 42 42 42 42 42 0 0 0 0 0 0 0 0 52 0 56 24 11 20 21 0 51 51 51 52 51 19 20 20 20 13 22 67 67 67 67 78 0 0 0 0 0 0 0 0 0 0 0 0 0 0 0 0 0 0 0 0 89 89 89 89 0 0 0 0 0 0 0 0 0 0 0 0 0 0 0 0 0 0 0 0 0 0 0 0 0 0 0 
0 0 0 0 0 0 0 0 0 0 0 0 0 0 0 0 0 0 0 0 0 0 0 0 56 67 67 24 11 21 0 0 0 0 0 52 52 0 0 0 0 0 19 20 20 20 13 89 22 67 67 67 78 0 0 0 0 0 0 0 0 0 0 0 0 0 0 0 0 8 89 11 21 0 0 0 0 0 0 0 0 0 0 0 0 0 0 0 0 0 0 0 0 0 0 0 0 0 0 0 
0 0 0 0 0 0 0 0 0 0 0 0 0 0 0 0 0 0 0 0 0 0 0 56 24 11 20 20 21 0 0 0 0 0 0 0 0 0 0 0 0 0 0 0 0 0 19 20 20 13 89 89 22 67 67 67 67 78 0 0 0 0 0 0 0 0 0 0 0 8 89 10 0 0 0 0 0 0 0 0 0 0 0 0 0 0 0 0 0 0 0 0 0 0 0 0 0 0 0 0 
0 0 0 0 0 0 0 0 0 0 0 0 0 0 0 0 0 0 0 0 0 56 67 24 11 21 0 0 0 0 0 0 0 0 0 0 0 0 0 0 0 0 0 0 0 0 0 0 0 19 20 20 20 20 20 20 13 22 78 0 0 0 0 0 0 0 0 0 56 24 11 21 0 0 0 0 0 0 0 0 0 0 0 0 0 0 0 0 0 0 0 0 0 0 0 0 0 0 0 0 
0 0 0 0 0 0 0 0 0 0 0 0 0 0 0 0 0 0 0 0 56 24 89 11 21 0 0 0 0 0 0 0 0 0 0 0 0 0 0 0 0 0 0 0 0 0 0 0 0 0 0 0 0 0 0 0 8 89 22 67 78 0 0 0 0 0 0 0 8 89 10 0 0 0 0 0 0 0 0 0 0 0 0 0 0 0 0 0 0 0 0 0 0 0 0 0 0 0 0 0 
0 0 0 0 0 0 0 0 0 0 0 0 0 0 0 0 0 0 0 0 8 89 11 21 0 0 0 0 0 0 0 0 0 0 0 0 0 0 0 0 0 0 0 0 0 0 0 0 0 0 0 0 0 0 0 0 8 89 89 89 22 67 78 0 0 0 0 0 8 11 21 0 0 0 0 0 0 0 0 0 0 0 0 0 0 0 0 0 0 0 0 0 0 0 0 0 0 0 0 0 
0 0 0 0 0 0 0 0 0 0 0 0 0 0 0 0 0 0 0 0 8 11 21 0 0 0 0 0 0 0 0 0 0 0 0 0 0 0 0 0 0 0 0 0 0 0 0 0 0 0 0 0 0 0 0 0 8 89 89 89 89 89 22 78 0 0 0 0 8 10 0 0 0 0 0 0 0 0 0 0 0 0 0 0 89 89 89 89 0 0 0 0 0 0 0 0 0 0 0 0 
0 0 0 0 0 0 0 0 0 0 0 0 0 0 0 0 0 0 56 67 24 10 0 0 0 0 0 0 0 0 0 0 0 0 0 0 0 0 0 0 0 0 0 0 0 0 0 0 0 0 0 0 0 0 0 0 19 13 89 89 89 89 89 22 78 0 0 0 8 10 0 0 0 0 0 0 0 0 0 0 89 89 89 89 89 89 89 89 89 89 89 89 0 0 0 0 0 0 0 0 
0 0 0 0 0 0 0 0 0 0 0 0 0 0 0 0 0 56 24 11 20 21 0 0 0 0 0 0 0 0 0 0 0 0 0 0 0 0 0 0 0 0 0 0 0 0 0 0 0 0 0 0 0 0 0 0 0 19 13 89 89 89 89 89 22 67 67 67 24 10 0 0 0 0 0 0 0 0 89 89 89 89 89 89 89 89 89 89 89 89 89 89 89 0 0 0 0 0 0 0 
0 0 0 0 0 0 0 0 0 0 0 0 0 0 56 67 67 24 11 21 0 0 0 0 0 0 0 0 0 0 0 0 0 0 0 0 0 0 0 0 0 0 0 0 0 0 0 0 0 0 0 0 0 0 0 0 0 0 19 13 89 89 89 89 89 89 89 89 89 22 67 78 0 0 0 89 89 89 89 89 89 89 89 89 89 89 89 89 89 89 89 89 89 89 0 0 0 0 0 0 
0 0 0 0 0 0 0 0 0 0 0 56 67 67 24 89 11 20 21 0 0 0 0 0 0 0 0 0 0 0 0 0 0 0 0 0 0 0 0 0 0 0 0 0 0 0 0 0 0 0 0 0 0 0 0 0 0 0 0 8 89 89 89 89 89 89 89 89 89 89 89 22 89 89 89 89 89 89 89 89 0 0 0 0 0 0 0 0 0 89 89 89 89 89 89 0 0 0 0 0 
0 0 0 0 0 0 0 56 67 67 67 24 89 11 20 20 21 0 0 0 0 0 0 0 0 0 0 0 0 0 0 0 0 0 0 0 0 0 0 0 0 0 0 0 0 0 0 0 0 0 0 0 0 0 0 0 0 0 0 19 13 89 89 89 89 89 89 89 89 89 89 89 89 89 89 89 89 89 0 0 0 0 0 0 0 0 0 0 0 0 0 0 89 89 89 89 0 0 0 0 
0 0 0 0 0 0 0 8 11 20 20 20 20 21 0 0 0 0 0 0 0 0 0 0 0 0 0 0 0 0 0 0 0 0 0 0 0 0 0 0 0 0 0 0 0 0 0 0 0 0 0 0 0 0 0 0 0 0 0 0 8 89 89 89 89 89 89 89 89 89 89 89 89 89 89 89 89 0 0 0 0 0 0 0 0 0 0 0 0 0 0 0 0 89 89 89 89 89 89 89 
0 0 0 0 0 0 56 24 10 0 0 0 0 0 0 0 0 0 0 0 0 0 0 0 0 0 0 0 0 0 0 0 0 0 0 0 0 0 0 0 0 0 0 0 0 0 0 0 0 0 0 0 0 0 0 0 0 0 0 0 8 89 89 89 89 89 89 89 89 89 89 89 89 89 89 89 89 89 89 0 0 0 0 0 0 0 0 0 0 0 0 0 0 0 0 89 89 89 89 89 
0 0 0 56 67 67 24 11 21 0 0 0 0 0 0 0 0 0 0 0 0 0 0 0 0 0 0 0 0 0 0 0 0 0 0 0 0 0 0 0 0 0 0 0 0 0 0 0 0 0 0 0 0 0 0 0 0 0 0 0 8 89 89 89 89 89 89 89 89 89 89 89 89 89 89 89 89 89 89 89 0 0 0 0 0 0 0 0 0 0 0 0 0 0 0 0 0 89 89 89 
67 67 67 24 89 89 11 21 0 0 0 0 0 0 0 0 0 0 0 0 0 0 0 0 0 0 0 0 0 0 0 0 0 0 0 0 0 0 0 0 0 0 0 0 0 0 0 0 0 0 0 0 0 0 0 0 0 0 0 0 8 89 89 89 89 89 89 89 89 89 89 89 89 89 0 0 0 89 89 89 89 89 0 0 0 0 0 0 0 0 0 0 0 0 0 0 0 0 89 89 
89 89 89 89 89 89 21 0 0 0 0 0 0 0 0 0 0 0 0 0 0 0 0 0 0 0 0 0 0 0 0 0 0 0 0 0 0 0 0 0 0 0 0 0 0 0 0 0 0 0 0 0 0 0 0 0 0 0 0 0 8 89 89 89 89 89 89 89 89 89 89 89 89 0 0 0 0 0 0 89 89 89 89 0 0 0 0 0 0 0 0 0 0 0 0 0 0 0 0 0 
89 89 89 89 11 21 0 0 0 0 0 0 0 0 0 0 0 0 0 0 0 0 0 0 0 0 0 0 0 0 0 0 0 0 0 0 0 0 0 56 67 78 0 0 0 0 0 0 0 0 0 0 0 0 0 0 0 0 0 0 8 89 89 89 89 89 89 89 89 89 89 89 89 0 0 0 0 0 0 0 0 89 89 0 0 0 0 0 0 0 0 0 0 0 0 0 0 0 0 0 
89 89 89 11 21 0 0 0 0 0 0 0 0 0 0 0 0 0 0 0 0 0 0 0 0 0 0 0 0 0 0 0 0 0 0 0 0 0 56 24 89 22 67 67 67 78 0 0 0 0 0 0 0 0 0 0 0 0 0 0 19 13 89 89 89 89 89 89 89 89 89 89 89 89 0 0 0 0 0 0 0 0 89 89 0 0 0 0 0 0 0 0 0 0 0 0 0 0 0 0 
20 20 20 21 0 0 0 0 0 0 0 0 0 0 0 0 0 0 0 0 0 0 0 0 0 0 0 0 0 0 0 0 0 0 0 0 0 0 8 89 89 89 89 89 89 22 67 67 67 78 0 0 0 0 0 0 0 0 0 0 0 8 89 89 89 89 89 89 89 89 89 89 89 89 0 0 0 0 0 0 0 0 89 89 89 89 0 0 0 0 0 0 0 0 0 0 0 0 0 0 
0 0 0 0 0 0 0 0 0 0 0 0 0 0 0 0 0 0 0 0 0 0 0 0 0 0 0 0 0 0 0 0 0 0 0 0 0 0 19 13 89 11 20 20 20 20 20 13 89 22 67 78 0 0 0 0 0 0 0 0 0 19 13 89 89 89 89 89 89 89 89 89 89 89 0 0 0 0 0 0 0 0 0 89 89 89 89 0 0 0 0 0 0 0 0 0 0 0 0 0 
0 0 0 0 0 0 0 0 0 0 0 0 0 0 0 0 0 0 0 0 0 0 0 0 0 0 0 0 0 0 0 0 0 0 0 0 0 0 0 19 20 21 0 0 0 0 0 19 13 89 89 22 78 0 0 0 0 0 0 0 0 0 8 89 89 89 89 89 89 89 89 89 89 89 89 0 0 0 0 0 0 0 0 0 89 89 89 89 89 89 89 89 0 0 0 0 0 0 0 0 
0 0 0 0 0 0 0 0 0 0 0 0 0 0 0 0 0 0 0 0 0 0 0 0 0 0 0 0 0 0 0 0 0 0 0 0 0 0 0 0 0 0 0 0 0 0 0 0 19 13 89 89 22 67 67 67 67 67 67 67 67 67 24 89 89 89 89 89 89 89 89 89 89 89 89 89 0 0 0 0 0 0 0 0 0 89 89 89 89 89 89 89 89 89 0 0 0 0 0 0 
0 0 0 0 0 0 0 0 0 0 0 0 0 0 0 0 0 0 0 0 0 0 0 0 0 0 0 0 0 0 0 0 0 0 0 0 0 0 0 0 0 0 0 0 0 0 0 0 0 8 89 89 89 89 89 89 89 89 89 89 89 89 89 89 89 89 89 89 89 89 89 89 89 89 89 89 0 0 0 0 0 0 0 0 0 0 0 0 0 0 89 89 89 89 89 0 0 0 0 0 
0 0 0 0 0 0 0 0 0 0 0 0 0 0 0 0 0 0 0 0 0 0 0 0 0 0 0 0 0 0 0 0 0 0 0 0 0 0 0 0 0 0 0 0 0 0 0 0 56 24 89 89 89 11 20 20 20 20 20 20 20 20 20 13 89 89 89 89 89 89 89 89 89 89 89 89 89 0 0 0 0 0 0 0 0 0 0 0 0 0 0 0 89 89 89 89 0 0 0 0 
0 0 0 0 0 0 0 0 0 0 0 0 0 0 0 0 0 0 0 0 0 0 0 0 0 0 0 0 0 0 0 0 0 0 0 0 0 0 0 0 0 0 0 0 0 0 0 56 24 89 89 11 20 21 0 0 0 0 0 0 0 0 0 19 20 13 89 89 89 89 89 89 89 89 89 89 89 0 0 0 0 0 0 0 0 0 0 0 0 0 0 0 0 89 89 89 89 0 0 0 
0 0 0 0 0 0 0 0 0 0 0 0 0 0 0 0 0 0 0 0 0 0 0 0 0 0 0 0 0 0 0 0 0 0 0 0 0 0 0 0 0 0 0 0 0 56 67 24 89 11 20 21 0 0 0 0 0 0 0 0 0 0 0 0 0 8 89 89 89 89 89 89 89 89 89 89 89 0 0 0 0 0 0 0 0 0 0 0 0 0 0 0 0 0 89 89 89 0 0 0 
0 0 0 0 0 0 0 0 0 0 0 0 0 0 0 0 0 0 0 0 0 0 0 0 0 0 0 0 0 0 0 0 0 0 0 0 0 0 0 0 0 0 0 56 67 24 11 20 20 21 0 0 0 0 0 0 0 0 0 0 0 0 0 0 0 8 89 89 89 89 89 89 89 89 89 89 89 0 0 0 0 0 0 0 0 0 0 0 0 0 0 0 0 0 0 89 89 89 0 0 
0 0 0 0 0 0 0 0 0 0 0 0 0 0 0 0 0 0 0 0 0 0 0 0 0 0 0 0 0 0 0 0 0 0 0 0 0 0 0 0 0 0 56 24 89 11 21 0 0 0 0 0 0 0 0 0 0 0 0 0 0 0 0 0 0 19 13 89 89 89 89 89 89 89 89 89 89 0 0 0 0 0 0 0 0 0 0 0 0 0 0 0 0 0 0 0 89 89 89 0 
0 0 0 0 0 0 0 0 0 0 0 0 0 0 0 0 0 0 0 0 0 0 0 0 0 0 0 0 0 0 0 0 0 0 0 0 0 0 0 0 0 56 24 11 20 21 0 0 0 0 0 0 0 0 0 0 0 0 0 0 0 0 0 0 0 0 8 89 89 89 89 89 89 89 89 89 89 89 0 0 0 0 0 0 0 0 0 0 0 0 0 0 0 0 0 0 89 89 89 0 
0 0 0 0 0 0 0 0 0 0 0 0 0 0 0 0 0 0 0 0 0 0 0 0 0 0 0 0 0 0 0 0 0 0 0 0 0 0 0 0 56 24 11 21 0 0 0 0 0 0 0 0 0 0 0 0 0 0 0 0 0 0 0 0 0 0 8 89 89 89 89 89 89 89 89 89 89 89 0 0 0 0 0 0 0 0 0 0 0 0 0 0 0 0 0 0 0 89 89 89 
0 0 0 0 0 0 0 0 0 0 0 0 0 0 0 0 0 0 0 0 0 0 0 0 0 0 0 0 0 0 0 0 0 0 0 0 0 0 0 0 8 89 10 0 42 42 0 42 42 0 0 0 0 0 0 0 0 0 0 0 0 0 0 0 0 0 8 89 89 89 89 89 89 89 89 89 89 89 0 0 0 0 0 0 0 0 0 0 0 0 0 0 0 0 0 0 0 89 89 89 
0 0 0 0 0 0 0 0 0 0 0 0 0 0 0 0 0 0 0 0 0 0 0 0 0 0 0 0 0 0 0 0 0 0 0 0 0 0 0 56 24 11 21 42 42 42 42 42 42 42 0 0 0 0 0 0 0 0 0 0 0 0 0 0 0 0 8 89 89 89 89 89 89 89 89 89 89 89 0 0 0 0 0 0 0 0 0 0 0 0 0 0 0 0 0 0 0 0 89 89 
0 0 0 0 0 0 0 0 0 0 0 0 0 0 0 0 0 0 0 0 0 0 0 0 0 0 0 0 0 0 0 0 0 0 0 0 0 0 0 8 11 21 0 42 0 0 0 42 42 42 0 0 0 0 0 0 0 0 0 0 0 0 0 0 0 0 8 89 89 89 89 89 89 89 89 89 89 89 89 0 0 0 0 0 0 0 0 0 0 0 0 0 0 0 0 0 0 0 89 89 
0 0 0 0 0 0 0 0 0 0 0 0 0 0 0 0 0 0 0 0 0 0 0 0 0 0 0 0 0 0 0 0 0 0 0 0 0 0 0 8 10 0 0 42 42 42 42 42 0 0 0 0 0 0 0 0 0 0 0 0 0 0 0 0 0 56 24 89 89 89 89 89 89 89 89 89 89 89 89 89 0 0 0 0 0 0 0 0 0 0 0 0 0 0 0 0 0 0 89 89 
0 0 0 0 0 0 0 0 0 0 0 0 0 0 0 0 0 0 0 0 0 0 0 0 0 0 0 0 0 0 0 0 0 0 0 0 0 0 0 8 10 0 0 42 42 42 42 0 0 0 0 0 0 0 0 0 0 0 0 0 0 0 0 0 56 24 89 89 89 89 89 89 89 89 89 89 89 89 89 89 89 89 0 0 0 0 0 0 0 0 0 0 0 0 0 0 0 89 89 89 
0 0 0 0 0 0 0 0 0 0 0 0 0 0 0 0 0 0 0 0 0 0 0 0 0 0 0 0 0 0 0 0 0 0 0 0 0 0 0 8 10 42 42 42 42 42 42 0 0 0 0 0 0 0 0 0 0 0 0 0 0 0 0 56 24 89 89 89 89 89 89 89 89 89 89 89 89 89 89 89 89 89 89 89 89 89 0 0 0 0 0 0 0 0 0 89 89 89 89 89 
0 0 0 0 0 0 0 0 0 0 0 0 0 0 0 0 0 0 0 0 0 0 0 0 0 0 0 0 0 0 0 0 0 0 0 0 0 0 0 8 10 42 42 0 42 0 0 0 0 0 0 0 0 0 0 0 0 0 0 0 0 0 56 24 89 89 89 89 89 89 89 89 89 89 89 89 89 89 89 89 89 89 89 89 89 89 89 89 89 89 89 89 89 89 89 89 89 89 89 89 
0 0 0 0 0 0 0 0 0 0 0 0 0 0 0 0 0 0 0 0 0 0 0 0 0 0 0 0 0 0 0 0 0 0 0 0 0 0 0 8 10 0 42 0 42 42 42 42 42 42 0 0 0 0 0 0 0 0 0 0 0 56 24 89 89 89 89 89 89 89 89 89 89 89 89 89 89 89 89 89 89 89 89 89 89 89 89 89 89 89 89 89 89 89 89 89 89 89 89 89 
0 0 0 0 0 0 0 0 0 0 0 0 0 0 0 0 0 0 0 0 0 0 0 0 0 0 0 0 0 0 0 0 0 0 0 0 0 0 0 8 10 0 42 0 42 42 0 0 0 42 0 0 0 0 0 0 0 0 0 0 56 24 89 89 89 89 89 89 89 89 89 89 89 89 89 89 89 89 89 89 89 89 89 89 89 89 89 89 89 89 89 89 89 89 89 89 89 89 89 89 
